am	Amstetten
b	Bregenz
ba	Bad Aussee
bl	Bruck an der Leitha
bm	Bruck an der Mur
bn	Baden
br	Braunau am Inn
bz	Bludenz
dl	Deutschlandsberg
do	Dornbirn
e	Eisenstadt
ef	Eferding
fb	Feldbach
fe	Feldkirchen
ff	Fürstenfeld
fk	Feldkirch
fr	Freistadt
g	Graz
gb	Gröbming
gd	Gmünd
gf	Gänserndorf
gm	Gmunden
gr	Grieskirchen
gs	Güssing
ha	Hallein
hb	Hartberg
he	Hermagor
hl	Hollabrunn
ho	Horn
i	Innsbruck 
im	Imst 
je	Jennersdorf
jo	St. Johann
ju	Judenburg
k	Klagenfurt
kb	Kitzbühel
kf	Knittelfeld
ki	Kirchdorf Krems
ko	Korneuburg
ks	Krems 
ku	Kufstein
l	Linz
la	Landeck
lb	Leibnitz
le	Leoben 
lf	Lilienfeld
li	Liezen
lz	Lienz
ma	Mattersburg
md	Mödling
me	Melk
mi	Mistelbach
mu	Murau
mz	Mürzzuschlag
nd	Neusiedl am See
nk	Neunkirchen
op	Oberpullendorf
ow	Oberwart
p	St. Pölten 
pe	Perg
ra	Radkersburg
re	Reutte
ri	Ried im Innkreis
ro	Rohrbach
s	Salzburg 
sb	Scheibbs
sd	Schärding
sp	Spittal an der Drau
sr	Steyr 
sv	Sankt Veit an der Glan
sw	Schwechat
sz	Schwaz
ta	Tamsweg
tu	Tulln
vb	Vöcklabruck
vi	Villach 
vk	Völkermarkt
vo	Voitsberg
w	Wien 
we	Wels 
wn	Wiener Neustadt 
wo	Wolfsberg
wt	Waidhofen an der Thaya
wy	Waidhofen an der Ybbs
wz	Weiz
ze	Zell am See
zt	Zwettl
