a	Alicante	
ab	Albacete	
al	Almería	
av	Ávila	
b	Barcelona	
ba	Badajoz	
bi	Bilbao 	
bu	Burgos	
c	A Coruña	
ca	Cádiz	
cc	Cáceres	
ce	Ceuta 
co	Córdoba	
cr	Ciudad Real	
cs	Castellón de la Plana
cu	Cuenca	
gc	Gran Canaria
lpgc	Las Palmas de Gran Canaria
gi	Girona
gr	Granada	
gu	Guadalajara	
h	Huelva	
hu	Huesca	
j	Jaén	
l	Lérida	
le	León	
lo	Logroño 
lu	Lugo	
m	Madrid	
ma	Málaga	
ml	Melilla 
mu	Murcia	
na	Navarra	
o	Oviedo 
ou	Orense
p	Palencia	
pa	Pamplona 
pm	Palma de Mallorca
po	Pontevedra	
s	Santander
sa	Salamanca	
se	Sevilla	
sg	Segovia	
so	Soria	
ss	San Sebastián
t	Tarragona	
te	Teruel
tf	Tenerife
sctf	Santa Cruz de Tenerife
to	Toledo	
v	Valencia	
va	Valladolid	
vi	Vitoria 
z	Zaragoza	
za	Zamora	
