bj	Bjelovar
bm	Beli Manastir
ck	Čakovec
čk	Čakovec
da	Daruvar
de	Delnice
dj	Đakovo
du	Dubrovnik
gs	Gospić
im	Imotski
ka	Karlovac
kc	Koprivnica
kr	Krapina
kt	Kutina
kz	Križevci
kž	Križevci
ma	Makarska
na	Našice
ng	Nova Gradiška
og	Ogulin
os	Osijek
pu	Pula
pz	Požega
pž	Požega
ri	Rijeka
sb	Slavonski Brod
sk	Sisak
sl	Slatina
st	Split
si	Šibenik
ši	Šibenik
vk	Vinkovci
vt	Virovitica
vu	Vukovar
vz	Varaždin
vž	Varaždin
zd	Zadar
zg	Zagreb
zu	Županja
žu	Županja
