ag	Agrigent
al	Alessandria
an	Ancona
ao	Valle d'Aosta
ap	Ascoli Piceno
aq	L'Aquila
ar	Arezzo
at	Asti
au	Apuania
av	Avellino
ba	Bari
bg	Bergamo
bi	Biella
bl	Belluno
bn	Benevento
bo	Bologna
br	Brindisi
bs	Brescia
bt	Barletta-Andria-Trani
bz	Bozen
ca	Cagliari
cb	Campobasso
ce	Caserta
cg	Castrogiovanni
ch	Chieti
ci	Carbonia-Iglesias
cl	Caltanissetta
cn	Cuneo
co	Como
cr	Cremona
cs	Cosenza
ct	Catania
cu	Cuneo
cz	Catanzaro
en	Enna
fc	Forlì-Cesena
fe	Ferrara
fg	Foggia
fi	Firenze
fo	Forlì
fr	Frosinone
fu	Fiume
ge	Genova
gi	Girgenti
go	Gorizia
gr	Grosseto
im	Imperia
is	Isernia
lc	Lecco
le	Lecce
li	Livorno
lo	Lodi
lt	Latina
lu	Lucca
mb	Monza e Brianza
mc	Macerata
me	Messina
mi	Milano
mn	Mantova
mo	Modena
ms	Massa-Carrara
mt	Matera
na	Napoli
no	Novara
nu	Nuoro
og	Ogliastra
or	Oristano
ot	Olbia-Tempio
pa	Palermo
pc	Piacenza
pd	Padova
pe	Pescara
pg	Perugia
pi	Pisa
pn	Pordenone
po	Prato
pr	Parma
ps	Pesaro Urbino
pt	Pistoia
pv	Pavia
pz	Potenza
ra	Ravenna
rc	Reggio Calabria
re	Reggio Emilia
rg	Ragusa
ri	Rieti
rm	Roma
rn	Rimini
ro	Rovigo
sa	Salerno
si	Siena
so	Sondrio
sp	La Spezia
sr	Siracusa
ss	Sassari
sv	Savona
ta	Taranto
te	Teramo
tn	Trento
to	Torino
tp	Trapani
tr	Terni
ts	Trieste
tv	Treviso
ud	Udine
va	Varese
vb	Verbano-Cusio-Ossola
vc	Vercelli
ve	Venezia
vi	Vicenza
vr	Verona
vs	Medio Campidano
vt	Viterbo
vv	Vibo Valentia
za	Zara
