bau	Augustów
bbi	Bielsk Podlaski
bgr	Grajewo
bha	Hajnówka
bi	Białystok
bkl	Kolno
bl	Łomża
bmn	Mońki
bs	Suwałki
bse	Sejny
bsi	Siemiatycze
bsk	Sokółka
bwm	Wysokie Mazowieckie
bza	Zambrów
cal	Aleksandrów Kujawski
cb	Bydgoszcz
cbr	Brodnica
cch	Chełmno
cg	Grudziądz
cgd	Golub-Dobrzyń
cin	Inowrocław
cli	Lipno
cmg	Mogilno
cna	Nakło nad Notecią
cra	Radziejów
cry	Rypin
cse	Sępólno Krajeńskie
csw	Świecie
ct	Toruń
ctu	Tuchola
cw	Włocławek
cwa	Wąbrzeźno
czn	Żnin
db	Wałbrzych
dbl	Bolesławiec
ddz	Dzierżoniów
dgl	Głogów
dgr	Góra
dj	Jelenia Góra
dja	Jawor
dka	Kamienna Góra
dkl	Kłodzko
dl	Legnica
dlb	Lubań
dlu	Lubin
dlw	Lwówek Śląski
dmi	Milicz
doa	Oława
dol	Oleśnica
dpl	Polkowice
dsr	Środa Śląska
dst	Strzelin
dsw	Świdnica
dtr	Trzebnica
dw	Wrocław
dwl	Wołów
dza	Ząbkowice Śląskie
dzg	Zgorzelec
dzl	Złotoryja
ebe	Bełchatów
ebr	Brzeziny
eku	Kutno
el	Łódź
ela	Łask
elc	Łowicz
ele	Łęczyca
eop	Opoczno
ep	Piotrków Trybunalski
epa	Pabianice
epd	Poddębice
epj	Pajęczno
era	Radomsko
erw	Rawa Mazowiecka
es	Skierniewice
esi	Sieradz
etm	Tomaszów Mazowiecki
ewe	Wieruszów
ewi	Wieluń
ezd	Zduńska Wola
ezg	Zgierz
fg	Gorzów Wielkopolski
fkr	Krosno Odrzańskie
fmi	Międzyrzecz
fnw	Nowa Sól
fsd	Strzelce Krajeńskie
fsl	Słubice
fsu	Sulęcin
fsw	Świebodzin
fws	Wschowa
fz	Zielona Góra
fza	Żary
fzg	Żagań
ga	Gdynia
gby	Bytów
gch	Chojnice
gcz	Człuchów
gd	Gdańsk
gda	Pruszcz Gdański
gka	Kartuzy
gks	Kościerzyna
gkw	Kwidzyn
gle	Lębork
gmb	Malbork
gnd	Nowy Dwór Gdański
gpu	Puck
gs	Słupsk
gsp	Sopot
gst	Starogard Gdański
gsz	Sztum
gtc	Tczew
gwe	Wejherowo
kbc	Bochnia
kbr	Brzesko
kch	Chrzanów
kda	Dąbrowa Tarnowska
kgr	Gorlice
kli	Limanowa
kmi	Miechów
kmy	Myślenice
kn	Nowy Sącz
knt	Nowy Targ
kol	Olkusz
kos	Oświęcim
kpr	Proszowice
kr	Kraków
ksu	Sucha Beskidzka
kt	Tarnów
ktt	Zakopane
kwa	Wadowice
kwi	Wieliczka
lb	Biała Podlaska
lbl	Biłgoraj
lc	Chełm
lhr	Hrubieszów
lja	Janów Lubelski
lkr	Kraśnik
lks	Krasnystaw
llb	Lubartów
lle	Łęczna
llu	Łuków
lop	Opole Lubelskie
lpa	Parczew
lpu	Puławy
lra	Radzyń Podlaski
lry	Ryki
lsw	Świdnik
ltm	Tomaszów Lubelski
lu	Lublin
lwl	Włodawa
lz	Zamość
nba	Bartoszyce
nbr	Braniewo
ndz	Działdowo
ne	Elbląg
nel	Ełk
ngi	Giżycko
ngo	Gołdap
nil	Iława
nke	Kętrzyn
nli	Lidzbark Warmiński
nmr	Mrągowo
nni	Nidzica
nnm	Nowe Miasto Lubawskie
no	Olsztyn
noe	Olecko
nos	Ostróda
npi	Pisz
nsz	Szczytno
nwe	Węgorzewo
ob	Brzeg
ogl	Głubczyce
ok	Kędzierzyn-Koźle
okl	Kluczbork
okr	Krapkowice
ona	Namysłów
ony	Nysa
ool	Olesno
op	Opole
opr	Prudnik
ost	Strzelce Opolskie
pch	Chodzież
pct	Czarnków
pgn	Gniezno
pgo	Grodzisk Wielkopolski
pgs	Gostyń
pja	Jarocin
pk	Kalisz
pke	Kępno
pkl	Koło
pkr	Krotoszyn
pks	Kościan
pl	Leszno
pmi	Międzychód
pn	Konin
pnt	Nowy Tomyśl
po	Poznań
pob	Oborniki
pos	Ostrów Wielkopolski
pot	Ostrzeszów
pp	Piła
ppl	Pleszew
pra	Rawicz
pse	Śrem
psl	Słupca
psr	Środa Wielkopolska
psz	Szamotuły
ptu	Turek
pwa	Wągrowiec
pwl	Wolsztyn
pwr	Września
pzl	Złotów
rbi	Ustrzyki Dolne
rbr	Brzozów
rde	Dębica
rja	Jarosław
rjs	Jasło
rk	Krosno
rkl	Kolbuszowa
rla	Łańcut
rle	Leżajsk
rls	Lesko
rlu	Lubaczów
rmi	Mielec
rni	Nisko
rp	Przemyśl
rpz	Przeworsk
rrs	Ropczyce
rsa	Sanok
rsr	Strzyżów
rst	Stalowa Wola
rt	Tarnobrzeg
rz	Rzeszów
sb	Bielsko-Biała
sbe	Będzin
sbl	Bieruń
sc	Częstochowa
sci	Cieszyn
sd	Dąbrowa Górnicza
sg	Gliwice
sh	Chorzów
si	Siemianowice Śląskie
sj	Jaworzno
sjz	Jastrzębie-Zdrój
sk	Katowice
skl	Kłobuck
sl	Ruda Śląska
slu	Lubliniec
sm	Mysłowice
smi	Mikołów
smy	Myszków
so	Sosnowiec
spi	Piekary Śląskie
sps	Pszczyna
sr	Rybnik
src	Racibórz
st	Tychy
sta	Tarnowskie Góry
sw	Świętochłowice
swd	Wodzisław Śląski
sy	Bytom
sz	Zabrze
sza	Zawiercie
szo	Żory
szy	Żywiec
tbu	Busko Zdrój
tje	Jędrzejów
tk	Kielce
tka	Kazimierza Wielka
tkn	Końskie
tlw	Włoszczowa
top	Opatów
tos	Ostrowiec Świętokrzyski
tpi	Pińczów
tsa	Sandomierz
tsk	Skarżysko-Kamienna
tst	Starachowice
tsz	Staszów
w	Warszawa
wbr	Białobrzegi
wci	Ciechanów
wg	Garwolin
wgm	Grodzisk Mazowiecki
wgr	Grójec
wgs	Gostynin
wkz	Kozienice
wl	Legionowo
wli	Lipsko
wls	Łosice
wm	Mińsk Mazowiecki
wma	Maków Mazowiecki
wml	Mława
wnd	Nowy Dwór Mazowiecki
wo	Ostrołęka
wor	Ostrów Mazowiecka
wot	Otwock
wp	Płock
wpi	Piaseczno
wpn	Płońsk
wpr	Pruszków
wpu	Pułtusk
wpy	Przysucha
wpz	Przasnysz
wr	Radom
ws	Siedlce
wsc	Sochaczew
wse	Sierpc
wsk	Sokołów Podlaski
wsz	Szydłowiec
wwe	Węgrów
wwl	Wołomin
wwy	Wyszków
wzu	Żuromin
wzw	Zwoleń
wzy	Żyrardów
zbi	Białogard
zch	Choszczno
zdr	Drawsko Pomorskie
zgl	Goleniów
zgr	Gryfino
zgy	Gryfice
zk	Koszalin
zka	Kamień Pomorski
zkl	Kołobrzeg
zlo	Łobez 
zmy	Myślibórz
zpl	Police
zpy	Pyrzyce
zs	Szczecin
zsd	Świdwin
zsl	Sławno
zst	Stargard Szczeciński
zsw	Świnoujście
zsz	Szczecinek
zwa	Wałcz
