ba	Bratislava
bb	Banská Bystrica
bj	Bardejov
bn	Bánovce nad Bebravou
br	Brezno
bs	Banská Štiavnica
by	Bytča
ca	Čadca
dk	Dolný Kubín
ds	Dunajská Streda
dt	Detva
ga	Galanta
gl	Gelnica
hc	Hlohovec
he	Humenné
il	Ilava
ka	Krupina
ke	Košice
kk	Kežmarok
km	Kysucké Nové Mesto
kn	Komárno
lc	Lučenec
le	Levoča
lm	Liptovský Mikuláš
lv	Levice
ma	Malacky
mi	Michalovce
ml	Medzilaborce
mt	Martin
my	Myjava
nr	Nitra
nm	Nové Mesto nad Váhom
no	Námestovo
nz	Nové Zámky
pb	Považská Bystrica
pd	Prievidza
pe	Partizánske
pk	Pezinok
pn	Piešťany
po	Prešov
pp	Poprad
pt	Poltár
pu	Púchov
ra	Revúca
rk	Ružomberok
rs	Rimavská Sobota
rv	Rožňava
sa	Šaľa
sb	Sabinov
sc	Senec
se	Senica
si	Skalica
sk	Svidník
sl	Stará Ľubovňa
sn	Spišská Nová Ves
so	Sobrance
sp	Stropkov
sv	Snina
tt	Trnava
tn	Trenčín
to	Topoľčany
tr	Turčianske Teplice
ts	Tvrdošín
tv	Trebišov
vk	Veľký Krtíš
vt	Vranov nad Topľou
za	Žilina
zc	Žarnovica
zh	Žiar nad Hronom
zm	Zlaté Moravce
zv	Zvolen
