s	Stockholm	
g	Gothenburg	
m	Malmö	
u	Uppsala	
v	Västerås	
ö	Örebro	
l	Linköping	
h	Helsingborg	
j	Jönköping	
n	Norrköping	
lu	Lund	
um	Umeå	
gä	Gävle	
so	Solna	
vx	Växjö	
sö	Södertälje	
b	Borås	
k	Karlstad	
e	Eskilstuna	
ha	Halmstad	
sv	Sundsvall	
bl	Borlänge	
ll	Luleå	
t	Trollhättan	
ld	Lidingö	
ös	Östersund	
ä	Ängelholm	
sb	Sundbyberg	
a	Alingsås	
f	Falun	
ks	Kristianstad	
kk	Karlskrona	
km	Kalmar	
sk	Skövde	
na	Nacka	
ny	Nyköping	
sk	Skellefteå	
